2 13 31
###############################
#p  d   x **   *   *  * * *   #
#   B F*# #**#***#*#*#*#*#*#* #
# s f b I  *   *   *   #   *  #
# # # # # #**#***#**#*#*#*#*#*#
#    1     #   *   *          #
# # # # # # #*# #*#*#*#*#*#*#*#
#*  *                2        #
# # # # #*# # # #*#*# # # # # #
#*    **  *       *           #
# #*# # # # # # #*# # # # # # #
#           *   *  *          #
###############################