5 13 31
###############################
#p * *3       *  ** * *      *#
# # # # #*# # #*# # # # # #*# #
#    * * *** **      *  3 **  #
# #*# # # # #4# #b#1# # # # #*#
#          *     **      *  **#
# # #*# # # # # #*#*#*#*# # # #
#   *        *   * *x* *   4  #
# # # # #*# #   #   # #*# #*# #
#   ****         *            #
# # # # # # # # # #*#       #*#
#  ** *1  *    2         1    #
###############################