3 13 31
###############################
#p   ** **    *   3           #
# # # #*# # # # # # # # # # # #
#*     ** * *  *   * **   *   #
# # # # # #*# # # # # # #*# # #
#*    s*    *** * x **        #
#     # # # # # # # # # # #*# #
#    *     *        *    **  3#
# #   # #*#*#*#*# # #1# # #*# #
#             2*    *   *     #
#*#     # # # # # # # #*# # #*#
# *    * **    ** ***     1   #
###############################