1 13 31
###############################
# B p#  bd                    #
#   #   f # # # # # # # # # # #
#  x    s                     #
#       # # # # # # # # # # # #
#f  IF                        #
# # # # # # # # # # # # # # # #
#                             #
# # # # # # # # # # # # # # # #
#                             #
# # # # # # # # # # # # # # # #
#                             #
###############################