1 13 31 
###############################
#   p#  * *  1 *   *  * * *   #
#  *#  *  # #*#*# # # #*#*#*# #
#  x*     *    *      *   * * #
#       # #*# # #*#*# # # # #*#
#fIbB        **  *  *         #
# # # # # # # # # #*# #*# # # #
#*  *      *  *      *        #
# # # # #*# # # #*#*# # # # # #
#*    **  *    1  *    1      #
# #*# # # # # # #*# # # # # # #
#           *   *  *   1      #
###############################